R 1500 900

NO ./textures/neonbrick512.xpm
SO ./textures/neonbrick512.xpm
WE ./textures/neonbrick512.xpm
EA ./textures/neonbrick512.xpm
S ./textures/kda512.xpm

C 0,0,0
F 0,0,0

111111111111111111111111
100000000000000000000001
100000000000000100000001
100000000001111010000001
100000000010000001000001
100000002100000000100001
100000E00200000000000111
100000002111111110000001
100000000000000000000001
100000000000000000001101
100000000000000000001001
100000000000000101001001
100000000000000000001001
100000000000000101001101
100000000000000000000001
111110111000000000000001
100000001000000000000001
100000201000000000000001
100100001000000000000001
110111111000000000000001
100000000000000000000001
100000000000000000000001
111111111111111111111111